1111111111
10000P0001
1000000001
10000C0001
1111111111