111111111111111111111111111111111111111111111111111
100000101010100C1000100010001100000101010100C100011
101010001000100010101010101010010100010001000101011
10P010100010101010100010100010000101000100010101001
101010101M001010101010100010001010001M0010100010101
101010000010001000100010101000101010000010001000101
101010101010101010100010101011010101010101010101001
100010100010101000101010101010000101000101010001001
101010101010101010100010100001010101010101010101001
10101C10001010100000101C1010010101C1000101010000001
101000101010101010101010001001010001010101010101001
101010100010101000101010101010010101000101010000001
101010101C100010101C100000100001010101C1000101010E1
111111111111111111111111111111111111111111111111111