111111
10M001
100P01
1E0C11
111111