1111111111111111111111
1000000000000000000001
1000000000000000P00001
1000000000000000000001
100000000010C000000001
1000000000000000000001
100E000000000000000001
1000000000000000000001
1111111111111111111111