111111111111111111111111111111111111
10M00010101010001000100010001100M001
10101000100010C010101010101010010101
1P001010001010101010M010100010000101
101010100010M01010101010C01000101001
10101000C0101010001000101010M0101011
101010101010101010100010101011010101
100010100010101000101010101010M00101
101010101010101010100010100001010101
101010100M0010000M001010101001010101
1010C0101010101010101010001001010C01
10101010C010101000101010101010010101
1010101010100010101C10000010000101E1
111111111111111111111111111111111111