111111111111111111111111111111111111
10M00010101010001000100010001100M001
10101000100010C010101010101010010101
10P01010001010101010M010100010000101
101010100010M01010101010C0100M101001
10101000C0101010001000101010M0101011
101010101010101010100010101011010101
10001010001010100010101010101M000101
101010101010101010100010100001010101
10101010M00010000M001010101001010101
1010C010101010101010M010001001010C01
10101010C0101010001C1010101010010101
1010101010100010101010100010000101E1
111111111111111111111111111111111111
