111111
1P0001
101101
101101
101101
101101
101101
101101
1E01C1
111111