111111
1M0001
1P0101
1E01C1
111111