111111
100001
1P0101
1E01C1
111111