111111
10M001
1P1011
1E1001
111111